+-+-+-+-+
|   | | |
+ + + + +
| |     |
+ +-+ + +
|   | | |
+ + + + +
| | | | |
+-+-+-+-+
