+-+-+-+-+-+
|         |
+ +-+ + +-+
|   | |   |
+-+-+ +-+-+
|         |
+-+-+ +-+ +
|   | | | |
+ + +-+ + +
| |       |
+-+-+-+-+-+
